.###################.
.#........#........#.
.#.##.###.#.###.##.#.
.#.................#.
.#.##.#.#####.#.##.#.
.#....#...#...#....#.
.####.###.#.###.####.
....#.#.......#.#....
#####.#.##.##.#.#####
........#...#........
#####.#.#####.#.#####
....#.#.......#.#....
.####.#.#####.#.####.
.#........#........#.
.#.##.###.#.###.##.#.
.#..#...........#..#.
.##.#.#.#####.#.#.##.
.#....#...#...#....#.
.#.######.#.######.#.
.#.................#.
.###################.