...##.#.##....##.#..#
...##.#.##....##.#..#
...##.#.##....##.#..#
...##.#.##....##.#..#
...##.#.##....##.#..#
...##.#.##....##.#..#
...##.#.##....##.#..#
...##.#.GG....##.#..#
...##.#.##....##.#..#
...##.#.##....##.#..#
...##.#.##....##.#..#
...##.#.XX....##.#..#
...##.#.##....##.#..#
...##.#.##....##.#..#
...##.#.##....##.#..#
...##.#.##....##.#..#
...##.#.##....##.#..#
...##.#.##....##.#..#
...##.#.##....##.#..#
...##.#.##....##.#..#
...##.#.##....##.#...