....#....#.#....#....
#.....#..###..#......
...X..#.......#..X...
XXXX..#########..XXXX
GGGGGGGGGGGGGGGGGGGGG
...XXXXXXX.XXXXXXX...
.....................
.....................
####......X......####
...GGGGG.....GGGGG...
.XX.....XXXXX.....XX.
...GGGGG.....GGGGG...
####......X......####
.....................
.....................
...XXXXXXX.XXXXXXX...
GGGGGGGGGGGGGGGGGGGGG
XXXX..#########..XXXX
...X..#.......#..X...
......#..###..#.....#
....#....#.#....#....